ssssssssssssssss
s00000000000000s
s00000000000000s
s00000000000000s
s000b000000b000s
s00000000000000s
s00000000000000s
s00000000000000s
s00000000000000s
s00555555555500s
s04444444444440s
sl333333333333ls
s02222222222220s
s00111111111100s
s00000000000000s
s00000000000000s
s00000000000000s
s00000000000000s
s00000000000000s
s00000000000000s
s00000000000000s
s00000000000000s
s00000000000000s
s00000000000000s