ssssssssssssssss
s00000000000000s
s00000000000000s
s00000000000000s
s0b0000000000b0s
s00000000000000s
s55555555555555s
s00444444444400s
s00003333330000s
s02020202020202s
sl010101010101ls
s00003333330000s
s00444444444400s
s55555555555555s
s00000000000000s
s00000000000000s
s00000000000000s
s00000000000000s
s00000000000000s
s00000000000000s
s00000000000000s
s00000000000000s
s00000000000000s
s00000000000000s
s00000000000000s