ssssssssssssssss
s00000000000000s
s00b00555500b00s
s00000000000000s
s0203l4050403l2s
sb0000000000000s
s00101010101010s
s0202020202020bs
s40404040404040s
sl5050505050505s
s4040404040404ls
s03030303030303s
s20202020202020s
s01010101010101s
s00000000000000s
s00000000000000s
s00000000000000s
s00000000000000s
s00000000000000s
s00000000000000s
s00000000000000s
s00000000000000s
s00000000000000s
s00000000000000s